id;nombre;goles_favor;goles_contra;diferencia_goles;puntos
1;River Plate;20;10;10;30
2;Boca Juniors;18;12;6;27
3;Independiente;15;15;0;21
4;Racing Club;14;16;-2;19
5;San Lorenzo;13;17;-4;16
6;VÃ©lez Sarsfield;12;18;-6;14
7;Rosario Central;11;19;-8;11
8;Newell's Old Boys;10;20;-10;9
9;Estudiantes de La Plata;9;21;-12;7
10;Gimnasia y Esgrima La Plata;8;22;-14;5